# # # # # # # # # #
# I # . . . . . . #
# . # . . # # . . #
# . # # . . # # . #
# . . # . # # M . #
# . # # . # # # # #
# . . . . . . . . #
# # # # # # # # # #
